GWWGGGGGGGGG
GWWWWWWWWGGG
GWWWWWWWWGGG
GWWGGGGWWWWG
GWWGGGGWWWWG
GWWGGGGWWWWG
GWWGGGGWWWWG
GWWWWWWWWWWG
GWWWWWWWWWWG
GGGGGGGGGGGG